NO ./textures/brick.xpm
SO ./textures/blue.xpm
WE ./textures/wood.xpm
EA ./textures/grey.xpm

F 224,97,105
C 120,231,255

11111111111111111111
10010000000000001001
10000000000000000001
10000000000000000001
10010000000000001001
10000000000000000001
10010000000000001001
10000000000000000001
10010000000000001001
1000000000000N000001
10010000000000001001
10000000000000000001
10010000000000001001
10000000000000000001
10010000000000001001
10000000000000000001
10010000000000001001
10000000000000000001
10010000000000001001
11111111111111111111