NO ./textures/brick.xpm
SO ./textures/blue.xpm
EA ./textures/grey.xpm
WE ./textures/wood.xpm

F 100,0,255
C 0,0,0

111111
1N1101
111001
110001
111111