NO ./textures/brick.xpm
SO ./textures/blue.xpm
WE ./textures/wood.xpm
EA ./textures/grey.xpm

F 224,172,105
C 205,249,255

        111111 111111111111111111
        1000011100110000000000001
        1011011101110000000000001
        10010000000000000N0000111
111111111011000001110000000000001
100000000011000011101111110111111
111011111111101110000001000111
  100111111111011101010010001
111000001101010111000000100011111111111111111111111111
  1100001000100000010000001000000000000000000000000011
111000000000000011010100001011111111111111101111111111
1100000111010101111101110000101           101
10110111 1110101 10111100000111           101
10000001 1000001 111111101111             101
1000000111000001 111111101111             101
1000000000000001 111111101111             101
1000000111110011 1111111011111111111111111101
10000001 1000001 1111111000000000000000000001
11111111 1111111 1111111111111111111111111111
