NO ./textures/brick.xpm
SO ./textures/blue.xpm
WE ./textures/wood.xpm
EA ./textures/grey.xpm

F 224,172,105
C 205,249,255

        111111 111111111111111111
        1000011100110000000000001
        1011011101110000000000001
        1001000000000000000000111
111111111011000001110000000000001
100000000011000011101111111111111
111011111111101110000001000111
 1110111111111011101010010001
111000001101010111000000100011111111111111111111111111
  1100001000N00000110000001001111111111111011111011111
111000000000000011010100100011111111111111111111111111
1100000111010101111101111000101
11110111 1110101 10111101000111
11111111 1111111 111111111111
11111111 1111111 111111111111
11111111 1111111 111111111111
11111111 1111111 111111111111
11111111 1111111 111111111111
11111111 1111111 111111111111
