NO ./textures/brick.xpm
SO ./textures/blue.xpm
WE ./textures/wood.xpm
EA ./textures/grey.xpm

F 224,172,105
C 205,249,255

        111111 111111111111111111
        1000011100110000000000001
        1011011101110000000000001
        1001000000000000000000111
111111111011000001110000000000001
100000000011000001110111111111111
111011111111101110000001000111
 11110111111111011101010010001
11100000110101011100000010001111
  110000000000000011000000100011111111111111
11100000000000001101010010001111
11000001110101011111011110N0101
11110111 1110101 10111101000111
11111111 1111111 111111111111